11111111111111111111
1P10C000000000000001
1010000C001111111101
10100000000000000101
101111111000000C0101
10000000000000000101
100000000000000001E1
11111111111111111111