1111111111111111111111111111111111111111111111111
1P100000CC000CCCCCC0000CCCCCC00000CCCCCCCCCC00001
1010111111111111111111111111111111111111111111101
101010C00C00C00000C000C00000C0000C000000000C00101
10101C1111111111111111111111111111111111111110101
101010100C00000000C000000000C00000000000000C10101
101C101011111111111111111111111111111111111C10101
101010101C00000000C000000000C00000000000001C10101
1C1010101C111111111111111111111111111111101C10101
101010101C100000C000000000C0000000000000101C10101
101010101C101111111111111111111111111110101C10101
101010101C1000C000000000C000000000000010101C10101
101010101C111111111111111111111111111010101C10101
101010101C000000C000000000C0000000000010101C10101
1010101011111111111111111111111111111110101C10101
101010100C00000000C000000000C00000000000101C10101
1010101111111111111111111111111111111111101C10101
101010000C00000000C000000000C00000000000001C10101
1010111111111111111111111111111111111111111C10101
101000000C00C00000C000C00000C00000000000000C10101
1011111111111111111111111111111111111111111110101
100000000C000CCCCCC0000CCCCCC00000000000000C001E1
1111111111111111111111111111111111111111111111111